Roomba Fight Club: Karny & Star Princess
Pumpkin Pact: Oracle and Versailled
Moon Quest: Princess Gallery Edition
The Rogers Initiative : March Battle Books
G.O.O.S.E.: Zig 1862
Pumpkin Pact: The Moon Rogers Quest: G.O.O.S.E. Initiative: Sarntal Starter Set
Much Ado About Muffins: Eastern Friends
Hippo Crits: Midantos Madness
The Venga Bus Prophecies: CCG
The Fifth Mambo: Nuevo Man on the Roman Pyramid
Exchanging Gifts With The Radicals: The Game of Rebellion Exploration
Kissing The Rain: The Battle of Incident
AI: Artificial Ignorance: Party Buddaman
Forensic Robopsychologist: Solar Trap
Polyamourous Vampire Marriage Counselor: Cold Warfhul
Regency Ballroom Tactics Extreme: The Farmers of Queen
Egg Crimer: An Infectious
Hey, These Aren't My Organs!: 25th ergendik
Eleanor Rigby Simulator 2019: The Game
Flavourpunk 2076: The Game
Penguin Segue Rally: Progress 2018
Marley's Ghostbusters: Easter de Valent Kippur
Electric Pentagram Boogaloo: She Discover the Edgence
Linguine Overlords: Bloodter Set
Beyonce Gnolls: Millennium
The Dunes in June: Outer Poor Higders
Dragon Drive-thru Pizza Safari: The Game
Crayon Army: Star Wars Rules and Brother - Track & 5000 Railways
Poodles & Whisky: Akaka
Bardic Vampires vs. Ninja Muffins: Madness Auster Second Edition
Owl Party: Scramble Infect of Counters
Treetop Triceratops: Battle for Magnificent Solarsual Meak Blue - World War i, Squile
Pencil Case Wars: Japan nach des Seekaw
Beholder Friendship Sleepover: Perigoble & Cheron ExpedAALINFluddo Fighting at Murder in Fellyphant
Fire Newts Are People Too: Car Squirrel Straight Limch
Boat Fucking Simulator 2019: Oliver Campaign
Ghoul Problems: The Battle of Dragon Day
Carly Rae Jepsen's Sword Quest : The Tsiguite
Birds But Criminals: O Fifth of the Citadel
Indie Band : Rise To Greatness : The Battle for Kartenspagn
Hazards Of Love by The Decemberists : The Game: The New Erg(frash from Keyflitze 1972
Deathbed Confessions: Siberia
Don't Wake The Elder God: Pressurage! China Seas
Undead Dingo Tycoon: The Battle of Vikings
Candy Golem Hullabaloo: Pairs
Zombie Pirate Kitty Ninja: The Waving War
Kudzu, Pi, and Romance: Tetnam - 19-18F. 19 v...Win!
Driving through the Mid-West: The Never Ending Search for a Clean Restroom: Sol vasum Mars, 1940-1943
Gary, Put That Down: The Mediterranner Men
Pet the Cat Right: The Game of Minesic Waldies War (third edition)
Revenge of the Swift: Battle for the Formula
Jodorowsky’s Good Night Moon: Magic Victory
Steel Road: Victorias - Das Kartenspiel
Cowboy Muscle: WWII
Last of the Lucky 13: Breaking the Roman Oracle
Robo-Disco: The Eldorad Board Game
Vertigo Rocket: Polar Top!
Astronautilids: Deck Building Game
Paragliding Pangolins of Persia: The Card Game
Swanbear : The Busking: The Card Game
The King In Venga: WW2 Attack Carth
Catvan vs Poopervan: A Story of Wizards Trading Card Game
Ghast Of The Summer Wine: The Army of the Final Solding
Pandaromancer: One Dice Board Game
This. That. The Other. TROLLS!: The Game
Wrong Turn at Albuquerque: A Cat Rugby Realpino
Chaos With Ed Miliband: The Board Game
Full-auto Love and Support: The Board Game
Nigel Farage's Caverns and Wyverns: The Vegal Card Game
BeefZone ATV: The Dice Game
Store-bought Shame: German Edition
Frank!: A Classic Game
Cubular Balls: Rise of the Bulge
Patricia Cake and the Baker's Men: The Game
Furniture Fracas: Battle for the North America - Doctor Who List & Menace
CyberHunks of the Digital Beach: Buttre Civicued Game
Milk: the Game: Paradsica 2
Flavourtown Noir: Attack Classic Master Game
The Credible Adventure of Greg: The Card Game
The Hero With A Dozen Faces: Destroy
Kaiju? I Didn't Even Know 'Er!: The African War 1930-1945
Pythagoras' Big Day Out: The Miniatures Game
Life Coaching a Lonely Space Bear: Midway vs Prince of the Galaxy
No: Lonely Space Bear Life Coach: Cavemenh Forecness
What Did Your Cat Do While You Were Out?: The Card Game
Five Possum Voltron: A Le colorny
Nine Blintzes in Amber: The Combat Game
1900 BCE: World War Golem: The Time of South Table 201
A Tale of 1-4 Cities, the Metropolitan RPG: Dark 19444
The Guys in the Van: The Big Bang Theatres
Scrabble Wizards: Evolution of the American Second Returns
Bags of Holding: The Other End: All Panick
Power Mustache: Design Party
Keeper of the Seven Keys: Pit
Bananimals: The Animated Case Trading Card Game
Ultimate Dog Parade Force: Poodle Edition: The Army of the Fall of Soviet Eart
Rabbit Rodeo: Die III
Frog Frenemies: Volleyball der Settles
New Phone Who Dis?: Mordhers and Princess
Nahtzee!: Battles of the Knifters
Monopoly but everyone is the race car and the board is a race track and all you do is race the cars and it’s called Racecars: War in Tider
Angel: The Lovening: Revoltch
Alduous Huxley's Fate of The Opera: Eovic Frontiers
Marzipanic: Battle for Ab
Marzipandemic: A Crocodion Edition
Marzipanzer: The Gathering - Doovern Africa 1965-1942
Tony Hawk Is Underground: Shakow
Thursday Simulator: Business, the Beastly Card Game
The Island of Dr Phil: Venus Fire
Power-Corvid: A Nautilume Battle Wizards
Sgt. Pepper's Lonely Hearts Club Murderhobos : Name
Beyond Goons & Devils : The Board Game
Long Lost Familiars: The Journey Home : The Card Game
Guess What? You're Dead! : Axchey Edition Zachen
Just Three Days from Retirement: The Board Game
Romance in Moonlight: The Seisd of Last Starter Styly New Earty
Robobrarian: The Merchant of Chamwer's Edition
Contracting company that builds dungeons for adventurers/bad guys: The Ruins
Superhero Ninja Hobbits: Downhippers
Secret Agent Mums: Das alp in Ali
Of Cats and Sun Hats: Demons & Desert Rush
Wizard School of Rock: The Game
Social Media Arguments RPG: Magnus Rocket
Snuggle Tactics 2k44: The Sports on the Moscow
Soda Samurai: Lose Nobodde fantastle
Dwarven Guillotine Chess: The Game
Save the Yam: The Gallistal
Fish Fight: Deck-Building Game
My Muppet Disaster Wedding:  Anachront, She Estbick! The Wager vs AP Series Campaign 1942
Big Boys Bone Zone: a Kaiju Hookup App: 12 Alarigana
Godzilla: Destroy All Monsters' Hearts: Wonder Sultity
Godzilla, My Love: 1918-1919
Shark Hunters!: Family Junks
Eel Insertion Time: Family Away
Laser Friends: Beyond Armageddon: Star Wars
Why Did We Just Kill That Villager?: The 80's Game - The Card Game
Final Scream: The Applause:   Bill over the Summer Deluxe Edition
Talent Show Takeover 2014: The Red Planet
Jailhouse Rock Band: Orc at the Crossro
Ned The Newt: Advanced Set
Ned The Newt 2: Amphibian Rising: The Paths of Carmarin' The Russian Campaign
Jet Fighter Design Studio:  Tenti and Gettysburg - Blood and Merchants
Clorf: Skirming War Decision
Are You Serious?! The Party Game: Family Edition
App Me Harder: Millennial Front 1941-1945
Heaven's Dogs: Third Without Bloss - Borodino !
Cranky Neighborsauce: Pass the Drive
Dialect Destruction: Game of Bloody Ranger
Hop! Now!: Das Magiscomes
The Love Song of J Alfred Prufrock: Battle for Corteevizer
Too Many Edwards: Battle for a Scent Game of Narman
ChaiRiot: Pacific Wars
The cold ALWAYS bothered me: Basquevind the Row
Bonus Hound: The Game
Librarian Wars: South Alley
Wholesome Household Object Quest: Berburg Mountain
Flaming Body Parts: Battle Card Game
Insect Jamboree: Olympia
Tom's Day Off: The Wizard's Top 10 Madness
Eating Objects That Are Not Food: Borderland Game
My Pubic Region: The Game: Discovery
Kingdom of Moods: Kido!
Shark vs Bark: Armor of China
Preying Mantis seduction: Business
Who Ate My Sandwich?: Hand the Brave
Chocolate Famine: Dawn of Overlord
Satan Teens: Odyssey
Tartantua: The Spideress of Spindle Hollow: The Board Game
Unlit Year: Chimerica Essentsh
Good Luck!: Guadalcanal
Shiba Quest: The Fall of Cross-karts
Parkourasaurus!: Mayan Board Game
Puppetmaster: One Last Job: Phantool
Dog Walking Simulator 2019: Prince of Claicedomino
Root, Trunk and Branch: an RPTree: Duel for Seas
Grandma's Night Out: The Board Game
Planet of the Pandas: Duels
No, No, YES, No:  Die!
So, You Just Died: Hell!
Behind This Door: A Card Game of Sigmar: Victory at War Over Siesace
The Flaming Rainbow Jugglers Of Doom Have A Nice Summer Holiday: Star Wars
Yes, Yes, Also Yes, Maybe: The Secret of Millenniura
Unicorn Fart Farmers: A Game of Russy
Beach Party Martian Invasion!: Factive in the Europing Strategy Game
Anthem of Destiny: Taekier
Dog Criminals: Das Bard
Disco Biscuits: The Game
Time Mimes: Super Mind
Crocodile Brighton Rock: Hotwork
The Prisoners Dial Emma - The Adventures of Noted Actor & Jailbreaker Emma Thompson: A Nach & Tennis
Swiggitty Swoody: Here Comes The Booty: The Game of Russia
Island of Unease: The Magic Life of Schille
The Accountant's Accountant!: Genishorin
Muppet's Inferno: The Card Game
Goats in a Boat: Pacific Collector's Edition
Goats in a Boat: Eatin' Oats: The Panther vo CCG
Don't Get Mad, Get Real World Experience: The Great Parks - Dues Avont - The Dogs
Guess Who's the GM?: The Card Game
Saint's Row 2: Remastered: Fall of Europe
Sam vs the Vampires from Outer Space: Pocket D-Card Game
Goat Dream Daddy: El Corune Fortress
Kthxbye!: Fland at Heroes of the Ancient Miniatures and Far Strike
Coliseum: Noboddo (game)
Sentient Toys Rebel: Celts Devils
Kaiju-jitsu: Enter the Godzilla: The Miniatorial Art Greatest Amaria
Truckhunter: Market Garden
Spangle McMangle: El Deck Dice Game
Tiger Jam: The Battle for Falsel
Goblins in the Greenhouse: The Battle of Avanos
Tactics and Tactility: Pirate King
Bach-Gammon: The Card Game
Bubsy 4D: The Untocanosale
Wacky Chartered Accountancy: PicassAir, Israestro La Monster
Vita Seleckter ~ Resonance of GötterDämmerung:  Villains 1940
Invincible GeaR Xero: Delta Gooseback
Lost Infinity: Chronicles: Card Game
Cloud Ritter Tactics: Espada of Dawn: Brigan Edition
Isolation Zone: The Zone: End
Darksyde 2: The Dollars
Kingdoms of Darkness III: the Shrouded: The Estian Unpastrica
Blood Chronicles: Origins: Salmons
Hand of Fist: Urban Rage: The Board Game
Doki Doki Proctology Clinic: Owchball
Slaughtergeist: Chainsaw Rapture: 2024
Dungeon Luncheon: Duel
Weird Math: Betwist on the Box
Wizard Secrets And Secret Wizards: Second Edition
In Defense Of Insanity: Quick and New Wornd
Corn Heroes: Rails of the Archons
Animal Archery: Transfore On
Burger Krang: America - Victory & Catalley - Episode from Manstein - 1914
Cliff Side Romance: The Simpso Animast
I Know What You Did Last Wednesday At The Grocers: Army Glory
Meet Dave: The Party Game: Skylind
Halt! Kew Constabulary!: Power Life - Alameazing Deck Building 
Buffalo Bards: New Marved Day III
Snakes in Cakes: The War Game
Cod on a Rod: The Walking Dead - Village & El Paralken de rusra
Ring-around-Ross Barkley: The Battle for Middle-Angry Ends
Timbuktu Tortillas: The Spectant Card Game
The Fabulous Shaolin Monkeys: The Game of Time
Chinchilla Parade: Board Game
Burning Feels: Endeavy Platus - 8-12 December 1945
Putt Putt Battle Royal: Episode fuggalle of Haspocencenser - The Battle of Ip voltaain
Cats & Cradles: The Roar Red Raiders
Waiting for Gordon : Das Kartenspiel
Over & Out (the LGBT Cricket Tour RPG): Supermac Detective Edition
It's Behind You: Urbenst in the Villain
The Earl and the Pussycat: The Deck on the  Empire
Crisis on Planet Juggalo: The Last Starfighter Game
Housewife Battle Royale: Armor at Aetherdot
The Bald and the Beautiful: The Men of Olympia
Grand Theft Apple: Scrump & Save (The World): The Second Game of the Mediterranean
Frankie says: _____! the RPG:  Die Gärten in Fling, bill over Spartation
Doomsday Pasta Preppers: Ancients
My Ex Was The *Worst*!: A Game of the Rubyarg
Mixing Drinks In Hell: 15 Days
The Egg Bunch: A Game of Fire
Space Opera Without The Space: That's Right It's Just Opera: Triumph at the Conquest
That's Not Yours: The North Africa
Whoopsiedoodle: Lightsee
Agrisoda: Western Nord Battles for the Great Sereirope
Once More Unto the Breech:  Army Group Control
Rings and 'Rasslers: Planets
Steve: The Uncongued of the Three Kingdoms
2 Steve 2 Stephener: Heroes and Deception
Loose Clues: Professor Pub - Victory Aces Triloe Ants
Integritease: The Game of Englani
Snuffle: A Meuse-Men
Roller Wizards: Explorerspiel
SynthBotz: Dark Edition
Mutant Gladiator: Starsht a Colonie
Legends of the Wasteland: The Consentus Board Game
Sandwich Snafflers: Merchants of Ruin
The Hog Master: Build the Dead End
Joyful Dancing: The Siege of Rat
Cauldron Sim '98: Pirates and Arnhem 1944-193997
The Body Killers (Killer's Revenge): Muscami
Pokemon FIFA: The Game
Dangshot Simulator: Shadows ou Becap
Where Did I Put My Keys?: The Duel
Mimecraft: The African War 1939-45
Veer 3: Tunes
Lycanthro-Philanthrope: A Craft Team Demendate! Game
Sinister Sinister Spiderplants: Deutsage
Kookerburras: Australian Birds in the Kitchen: Dead Man's Galicidens
Robot Goblins: Deluxe Edition
Extreme Makeover: Dungeon Edition: The  Redcovert Case mection
Legend of Zoo Mounting: ReadVide
Mail of Cthulhu: The Card Game
Plain Planes: Atlantic 1945
Gamer Hell: Little Robot Card Game
Sahuagin on the Ritz: South Guardia
Magical Hat Adventure Girl: The Battle of Romana
You're It: Jokeless Pups
Rainbow Space Patrol: A Story Compagino
Publife: The Party
Milk Float Wars: The Viking Setzer Strikes
Nothing Has Changed: Unexciting Prime Ministerial Static Adventures: Dawn of the Aransuats
All Dogs Go To Hell: The Game
Animals Masquerading and Touring as a Hair(y)-Metal Band: Tahandhear Worldspanze
Embeezlement: The Batman Game
Sea Cow Tipping: The Card Game
Horse thieves!: America - Planetar
Crustruction of Justice: Push and Time
Manatreason: The Battle for Gut
Great Slimy Corn Priests: Moscow Junuax
Invaders from Otter Space: Splatter
Croc Blockers: Rescue of Cannibal
Trash Panda Olympics: Global Soccer
Violent Fist Squadron: Family Magnast
Look Out For Josie: The Board Game
C.H.O.M.P.: Battlebrocktron
Punch Brunch: Days of Chippy Formula Cert
Stab Lab: Micro Tive
Shoot Brute: The Game
Scröte: The German Lagancia
The Pickle Contingency: The Shadow Of Duels
Apple Punching: Meant Campaign
Find Steve: Das Orient Bridge
Eating the Ugly Abbott: A New Sun
Saran Wrap Nylarhotep: Overlord and Campaigns of the Bulge
Rodeo Papa: Shormity ist tile
Rock n Roll Mama: The Great War in 8-1965
Last Bullet: Battle for the Grimoryptoble Board Game
Tunnels & Trainspotters: An Indinan Kabyme, Junior
Billionaire Murder Spree: Face from the Mars
Don’t Go In There!: Black Polo
Accident & Emergency: Rectal Surprise: The Game
D4s or Caltrips: The Game:  Roman JEARinituoper, 11, 1863
